######B#
###### #
####   #
####  ##
      ##
A#######